###############################
#                             #
# ############### #############
#                             #
#   #### ##############       #
#      # #                    #
#      # ##############       #
#                             #
###############################